###############
#   P         #
#      X      #
#        O    #
###############
